{
  accentColor: false, //	The accent-color utilities like accent-green-800
  accessibility: false, //	The sr-only and not-sr-only utilities
  alignContent: true, // The align-content utilities like content-between
  alignItems: true, // The align-items utilities like items-center
  alignSelf: true, // The align-self utilities like self-end
  animation: false, // The animation utilities like animate-ping
  appearance: false, // The appearance utilities like appearance-none
  aspectRatio: false, // The aspect-ratio utilities like aspect-square
  backdropBlur: false, // The backdrop-blur utilities like backdrop-blur-md
  backdropBrightness: false, // The backdrop-brightness utilities like backdrop-brightness-100
  backdropContrast: false, // The backdrop-contrast utilities like backdrop-contrast-100
  backdropFilter: false, // The backdrop-filter utilities like backdrop-filter
  backdropGrayscale: false, // The backdrop-grayscale utilities like backdrop-grayscale-0
  backdropHueRotate: false, // The backdrop-hue-rotate utilities like backdrop-hue-rotate-30
  backdropInvert: false, // The backdrop-invert utilities like backdrop-invert-0
  backdropOpacity: false, // The backdrop-opacity utilities like backdrop-opacity-50
  backdropSaturate: false, // The backdrop-saturate utilities like backdrop-saturate-100
  backdropSepia: false, // The backdrop-sepia utilities like backdrop-sepia-0
  backgroundAttachment: false, // The background-attachment utilities like bg-local
  backgroundBlendMode: false, // The background-blend-mode utilities like bg-blend-color-burn
  backgroundClip: false, // The background-clip utilities like bg-clip-padding
  backgroundColor: true, // The background-color utilities like bg-green-800
  backgroundImage: false, // The background-image utilities like bg-gradient-to-br
  backgroundOpacity: false, // The background-color opacity utilities like bg-opacity-25
  backgroundOrigin: false, // The background-origin utilities like bg-origin-padding
  backgroundPosition: true, // The background-position utilities like bg-left-top
  backgroundRepeat: true, // The background-repeat utilities like bg-repeat-x
  backgroundSize: true, // The background-size utilities like bg-cover
  blur: false, // The blur utilities like blur-md
  borderCollapse: false, // The border-collapse utilities like border-collapse
  borderColor: true, // The border-color utilities like border-green-800
  borderOpacity: false, // The border-color opacity utilities like border-opacity-25
  borderRadius: true, // The border-radius utilities like rounded-lg
  borderSpacing: false, // The border-spacing utilities like border-spacing-x-28
  borderStyle: false, // The border-style utilities like border-dotted
  borderWidth: true, // The border-width utilities like border-4
  boxDecorationBreak: false, // The box-decoration -break utilities like decoration-clone
  boxShadow: false, // The box-shadow utilities like shadow-lg
  boxShadowColor: true, // The box-shadow-color utilities like shadow-green-800
  boxSizing: false, // The box-sizing utilities like box-border
  breakAfter: false, // The break-after utilities like break-after-avoid-page
  breakBefore: false, // The break-before utilities like break-before-avoid-page
  breakInside: false, // The break-inside utilities like break-inside-avoid
  brightness: false, // The brightness utilities like brightness-100
  captionSide: false, // The caption-side utilities like caption-top
  caretColor: false, // The caret-color utilities like caret-green-800
  clear: false, // The clear utilities like clear-left
  columns: false, // The columns utilities like columns-auto
  contain: false, // The contain utilities like contain-size
  container: true, // The container component
  content: false, // The content utilities like content-none
  contrast: false, // The contrast utilities like contrast-100
  cursor: true, // The cursor utilities like cursor-grab
  display: false, // The display utilities like table-column-group
  divideColor: false, // The between elements border-color utilities like divide-slate-500
  divideOpacity: false, // The divide-opacity utilities like divide-opacity-50
  divideStyle: false, // The divide-style utilities like divide-dotted
  divideWidth: false, // The between elements border-width utilities like divide-x-2
  dropShadow: false, // The drop-shadow utilities like drop-shadow-lg
  fill: false, // The fill utilities like fill-green-700
  filter: false, // The filter utilities like filter
  flex: true, // The flex utilities like flex-auto
  flexBasis: true, // The flex-basis utilities like basis-px
  flexDirection: true, // The flex-direction utilities like flex-row-reverse
  flexGrow: true, // The flex-grow utilities like flex-grow
  flexShrink: true, // The flex-shrink utilities like flex-shrink
  flexWrap: true, // The flex-wrap utilities like flex-wrap-reverse
  float: false, // The float utilities like float-right
  fontFamily: false, // The font-family utilities like font-serif
  fontSize: true, // The font-size utilities like text-3xl
  fontSmoothing: false, // The font-smoothing utilities like antialiased
  fontStyle: false, // The font-style utilities like italic
  fontVariantNumeric: false, // The font-variant-numeric utilities like oldstyle-nums
  fontWeight: false, // The font-weight utilities like font-medium
  forcedColorAdjust: false, // The forced-color-adjust utilities like forced-color-adjust-auto
  gap: false, // The gap utilities like gap-x-28
  gradientColorStops: false, // The gradient-color-stops utilities like via-emerald-700
  grayscale: false, // The grayscale utilities like grayscale-0
  gridAutoColumns: false, // The grid-auto-columns utilities like auto-cols-min
  gridAutoFlow: false, // The grid-auto-flow utilities like grid-flow-dense
  gridAutoRows: false, // The grid-auto-rows utilities like auto-rows-min
  gridColumn: false, // The grid-column utilities like col-span-6
  gridColumnEnd: false, // The grid-column-end utilities like col-end-7
  gridColumnStart: false, // The grid-column-start utilities like col-start-7
  gridRow: false, // The grid-row utilities like row-span-6
  gridRowEnd: false, // The grid-row-end utilities like row-end-7
  gridRowStart: false, // The grid-row-start utilities like row-start-7
  gridTemplateColumns: false, // The grid-template-columns utilities like grid-cols-7
  gridTemplateRows: false, // The grid-template-rows utilities like grid-rows-7
  height: true, // The height utilities like h-96
  hueRotate: false, // The hue-rotate utilities like hue-rotate-30
  hyphens: false, // The hyphens utilities like hyphens-manual
  inset: false, // The inset utilities like end-44
  invert: false, // The invert utilities like invert-0
  isolation: false, // The isolation utilities like isolate
  justifyContent: true, // The justify-content utilities like justify-center
  justifyItems: true, // The justify-items utilities like justify-items-end
  justifySelf: true, // The justify-self utilities like justify-self-end
  letterSpacing: true, // The letter-spacing utilities like tracking-normal
  lineClamp: false, // The line-clamp utilities like line-clamp-4
  lineHeight: false, // The line-height utilities like leading-9
  listStyleImage: false, // The list-style-image utilities like list-image-none
  listStylePosition: false, // The list-style-position utilities like list-inside
  listStyleType: false, // The list-style-type utilities like list-disc
  margin: true, // The margin utilities like me-28
  maxHeight: true, // The max-height utilities like max-h-44
  maxWidth: true, // The max-width utilities like max-w-80
  minHeight: true, // The min-height utilities like min-h-44
  minWidth: true, // The min-width utilities like min-w-36
  mixBlendMode: false, // The mix-blend-mode utilities like mix-blend-hard-light
  objectFit: false, // The object-fit utilities like object-fill
  objectPosition: false, // The object-position utilities like object-left-top
  opacity: true, // The opacity utilities like opacity-50
  order: false, // The order utilities like order-8
  outlineColor: false, // The outline-color utilities like outline-green-800
  outlineOffset: false, // The outline-offset utilities like outline-offset-2
  outlineStyle: false, // The outline-style utilities like outline-dashed
  outlineWidth: false, // The outline-width utilities like outline-2
  overflow: true, // The overflow utilities like overflow-x-hidden
  overscrollBehavior: false, // The overscroll-behavior utilities like overscroll-y-contain
  padding: true, // The padding utilities like pe-28
  placeContent: false, // The place-content utilities like place-content-between
  placeItems: false, // The place-items utilities like place-items-center
  placeSelf: false, // The place-self utilities like place-self-end
  placeholderColor: false, // The placeholder color utilities like placeholder-red-600
  placeholderOpacity: false, // The placeholder color opacity utilities like placeholder-opacity-25
  pointerEvents: false, // The pointer-events utilities like pointer-events-none
  position: true, // The position utilities like absolute
  preflight: false, // Tailwind's base/reset styles
  resize: false, // The resize utilities like resize-y
  ringColor: false, // The ring-color utilities like ring-green-800
  ringOffsetColor: false, // The ring-offset-color utilities like ring-offset-green-800
  ringOffsetWidth: false, // The ring-offset-width utilities like ring-offset-2
  ringOpacity: false, // The ring-opacity utilities like ring-opacity-50
  ringWidth: false, // The ring-width utilities like ring-4
  rotate: false, // The rotate utilities like rotate-6
  saturate: false, // The saturate utilities like saturate-100
  scale: false, // The scale utilities like scale-x-95
  scrollBehavior: false, // The scroll-behavior utilities like scroll-auto
  scrollMargin: false, // The scroll-margin utilities like scroll-me-28
  scrollPadding: false, // The scroll-padding utilities like scroll-pe-28
  scrollSnapAlign: false, // The scroll-snap-align utilities like snap-end
  scrollSnapStop: false, // The scroll-snap-stop utilities like snap-normal
  scrollSnapType: false, // The scroll-snap-type utilities like snap-y
  sepia: false, // The sepia utilities like sepia-0
  size: true, // The size utilities like size-0.5
  skew: false, // The skew utilities like skew-x-12
  space: false, // The "space-between" utilities like space-x-4
  stroke: false, // The stroke utilities like stroke-green-700
  strokeWidth: false, // The stroke-width utilities like stroke-1
  tableLayout: false, // The table-layout utilities like table-auto
  textAlign: false, // The text-align utilities like text-right
  textColor: true, // The text-color utilities like text-green-800
  textDecoration: false, // The text-decoration utilities like overline
  textDecorationColor: false, // The text-decoration-color utilities like decoration-green-800
  textDecorationStyle: false, // The text-decoration-style utilities like decoration-dotted
  textDecorationThickness: false, // The text-decoration-thickness utilities like decoration-4
  textIndent: false, // The text-indent utilities like indent-28
  textOpacity: false, // The text-opacity utilities like text-opacity-50
  textOverflow: true, // The text-overflow utilities like overflow-ellipsis
  textTransform: false, // The text-transform utilities like lowercase
  textUnderlineOffset: false, // The text-underline-offset utilities like underline-offset-2
  textWrap: false, // The text-wrap utilities like text-nowrap
  touchAction: false, // The touch-action utilities like touch-pan-right
  transform: false, // The transform utility(for enabling transform features)
  transformOrigin: true, // The transform-origin utilities like origin-bottom-right
  transitionDelay: true, // The transition-delay utilities like delay-200
  transitionDuration: true, // The transition-duration utilities like duration-200
  transitionProperty: true, // The transition-property utilities like transition-colors
  transitionTimingFunction: true, // The transition-timing-function utilities like ease -in
  translate: false, // The translate utilities like translate-x-full
  userSelect: false, // The user-select utilities like select-text
  verticalAlign: false, // The vertical-align utilities like align-bottom
  visibility: true, // The visibility utilities like invisible
  whitespace: true, // The whitespace utilities like whitespace-pre
  width: true, // The width utilities like w-2.5
  willChange: false, // The will-change utilities like will-change-scroll
  wordBreak: false, // The word -break utilities like break-words
  zIndex: false, // The z-index utilities like z-30
}
